



"   ┌-----┐   "
"   |     |   "
"   |     |   "
"   |     |   "
"   |  ↑  |   "
"   |     |   "




"---------┐   "
"         |   "
"---┐     |   "
"   |     |   "
"   |  ↑  |   "
"   |     |   "




"   ┌---------"
"   |         "
"   |     ┌---"
"   |     |   "
"   |  ↑  |   "
"   |     |   "




"-------------"
"             "
"---┐     ┌---"
"   |     |   "
"   |  ↑  |   "
"   |     |   "




"   ┌-----┐   "
"---┘     |   "
"         |   "
"---┐     |   "
"   |  ↑  |   "
"   |     |   "




"   ┌-----┐   "
"   |     └---"
"   |         "
"   |     ┌---"
"   |  ↑  |   "
"   |     |   "




"   ┌-----┐   "
"---┘     └---"
"             "
"---┐     ┌---"
"   |  ↑  |   "
"   |     |   "




"   ┌-----┐   "
"   |     |   "
"---┘     |   "
"         |   "
"---┐  ↑  |   "
"   |     |   "




"   ┌-----┐   "
"   |     |   "
"   |     └---"
"   |         "
"   |  ↑  ┌---"
"   |     |   "




"   ┌-----┐   "
"   |     |   "
"---┘     └---"
"             "
"---┐  ↑  ┌---"
"   |     |   "




"   ┌---------"
"---┘         "
"         ┌---"
"---┐     |   "
"   |  ↑  |   "
"   └-----┘   "




"   ┌---------"
"---┘         "
"         ┌---"
"---┐     |   "
"   |  ↑  |   "
"   └-----┘   "




"   ┌---------"
"---┘         "
"         ┌---"
"---┐     |   "
"   |  ↑  |   "
"   └-----┘   "




"   ┌---------"
"---┘         "
"         ┌---"
"---┐     |   "
"   |  ↑  |   "
"   └-----┘   "




"   ┌---------"
"---┘         "
"         ┌---"
"---┐     |   "
"   |  ↑  |   "
"   └-----┘   "




"   ┌---------"
"---┘         "
"         ┌---"
"---┐     |   "
"   |  ↑  |   "
"   └-----┘   "

